証	英雄の証	
骨	凶骨	
牙	竜の牙	
塵	虚影の塵	
鎖	愚者の鎖	
毒針	万死の毒針	
髄液	魔術髄液	
鉄杭	宵哭きの鉄杭	
火薬	励振火薬	
種	世界樹の種	
ﾗﾝﾀﾝ	ゴーストランタン	
八連	八連双晶	
蛇玉	蛇の宝玉	
羽根	鳳凰の羽根	
歯車	無間の歯車	
頁	禁断の頁	
ホム	ホムンクルスベビー	
蹄鉄	隕蹄鉄	
勲章	大騎士勲章	
貝殻	追憶の貝殻	
勾玉	枯淡勾玉	
結氷	永遠結氷	
指輪	巨人の指輪	
ｵｰﾛﾗ	オーロラ鋼	
爪	混沌の爪	
心臓	蛮神の心臓	
逆鱗	竜の逆鱗	
根	精霊根	
幼角	戦馬の幼角	
涙石	血の涙石	
脂	黒獣脂	
ﾗﾝﾌﾟ	封魔のランプ	
ｽｶﾗﾍﾞ	智慧のスカラベ	
産毛	原初の産毛	
胆石	呪獣胆石	
神酒	奇奇神酒	
剣	剣	セイバー
弓	弓	アーチャー
槍	槍	ランサー
騎	騎	ライダー
術	術	キャスター
殺	殺	アサシン
狂	狂	バーサーカー
輝石	の輝石	
魔石	の魔石	
秘石	の秘石	
ピース	ピース	
モニュ	モニュメント	
